שְׁמַע יִשְׂרָאֵל יְהוָה אֱלֹהֵינוּ יְהוָה אֶחָד|Hear, O Israel: the Lord is our God, the Lord is one
בְּרֵאשִׁית בָּרָא אֱלֹהִים אֵת הַשָּׁמַיִם וְאֵת הָאָרֶץ|In the beginning, God created the heavens and the earth
וְאָהַבְתָּ לְרֵעֲךָ כָּמוֹךָ|Love your neighbor as yourself
זָכוֹר אֵת יוֹם הַשַּׁבָּת לְקַדְּשׁוֹ|Remember the Sabbath day to sanctify it
כִּי אֲנִי יְהוָה אֱלֹהֶיךָ|For I am the Lord your God
לֹא תִרְצָח|You shall not murder
לֹא תִנְאָף|You shall not commit adultery
לֹא תִגְנֹב|You shall not steal
לֹא תַעֲנֶה בְרֵעֲךָ עֵד שָׁקֶר|You shall not bear false witness against your neighbour
אֲנִי יְהוָה אֱלֹהֶיךָ אֲשֶׁר הוֹצֵאתִיךָ מֵאֶרֶץ מִצְרַיִם מִבֵּית עֲבָדִים|I am the Lord your God, who brought you out of the land of Egypt, out of the house of slavery
לֹא יִהְיֶה לְךָ אֱלֹהִים אֲחֵרִים עַל-פָּנָי|You shall have no other gods before Me
לֹא-תַעֲשֶׂה לְךָ פֶסֶל|You shall not make for yourself a carved image
לֹא תִשָּׂא אֶת-שֵׁם-יְהוָה אֱלֹהֶיךָ לַשָּׁוְא|Do not take the name of the Lord your God in vain
כַּבֵּד אֶת-אָבִיךָ וְאֶת-אִמֶּךָ|Honor your father and your mother
לֹא-תַעֲנֶה בְרֵעֲךָ עֵד שָׁקֶר|Do not bear false witness against your neighbor
לֹא תַחְמֹד בֵּית רֵעֶךָ|You shall not covet your neighbor’s house
לֹא תַחְמֹד אֵשֶׁת רֵעֶךָ|You shall not covet your neighbor’s wife
אֲנִי הַדֶּרֶךְ וְהָאֱמֶת וְהַחַיִּים|I am the way, the truth, and the life (Torah context as life guidance)
וַיַּבְרֶךְ אֱלֹהִים אֶת-הַשַּׁבָּת|And God blessed the Sabbath
וְאָהַבְתָּ לְרֵעֲךָ כָּמוֹךָ|You shall love your neighbor as yourself
לֹא-תִשָּׁכַב אֶת-אִשְׁתּוֹ שֶׁל רֵעֶךָ|Do not lie with your neighbor’s wife
וְצִדְקוֹתֶיךָ כְּרוּחַ הָאֱלֹהִים|Your righteousness is like the spirit of God
שָׁלוֹם רָב יִהְיֶה בְּתוֹכֵךְ|Let there be abundant peace within you
אֱמֶת וְצֶדֶק יְשַׁקְּפוּ-פָּנֶיךָ|Truth and justice shall shine before you
וְהִזְכַּרְתָּ אֶת-יְהוָה אֱלֹהֶיךָ|And you shall remember the Lord your God
וְשָׁמַרְתֶּם אֶת-כָּל-הַדְּבָרִים|And you shall observe all the words
וְהָיָה בְרָכָה בָּרֵאשִׁית|And there shall be blessing in the beginning
כִּי יְהוָה יְבָרֶכְךָ|For the Lord shall bless you
לֹא-תִשָּׂא עַל-לְבַבְךָ|Do not lift your heart in pride
אַל-תִּתְאַוֶּה לָרָע|Do not desire evil
וְתִשְׁמְרוּ מִצְוֹתָי|And you shall keep My commandments
וְלֹא תָרִימוּ יָדְכֶם|And you shall not raise your hands to violence
וְלֹא תִרְאֶה בְּנֵי עַמִּים אֲחֵרִים|And you shall not observe other peoples
וְהָיָה תּוֹרָתִי בְּלֵבְכֶם|And My teaching shall be in your heart
וְלֹא תָשׁוּב מֵרִשְׁעִים|And do not turn from the wicked
וְאֶת-כָּל-הַדְּבָרִים תִּשְׁמְרוּ|And you shall observe all the words
הַיּוֹם אֲנִי מְצַוֶּה אֶתְכֶם|Today I command you
וְאָהַבְתָּ אֶת-יְהוָה אֱלֹהֶיךָ|And you shall love the Lord your God
וְחַיִּים וּמָוֶת נָתַתִּי לְפָנֶיךָ|I have set before you life and death
וּבָחַרְתָּ בַּחַיִּים|And you shall choose life
וְהָיָה לְעֵדוּת לְדֹרֹתֵיכֶם|And it shall be for a testimony to your generations
וְלֹא תִשְׁכַּח אֶת-מַעֲשֵׂי יְהוָה|And do not forget the deeds of the Lord
וְהָיָה כִּי תִבְנוּ בָּיִת|And it shall be when you build a house
וְאָהַבְתָּ אֶת-רֵעֶךָ כָּמוֹךָ|And you shall love your neighbor as yourself
וְתִהְיֶה עֲמִיד לְכָל-דָּבָר|And you shall be steadfast in all things
אַל-תִּירָא מִפְּנֵי-אַיִלִים|Do not fear the wild beasts
וְאַל-תֵּצֵא בְּלֵבָבְךָ|And do not go out with a troubled heart
וְשָׁמַרְתָּ אֶת-לִבְּךָ|And guard your heart
וְאָמַרְתָּ בְתִפְלָה|And you shall speak in prayer
וְהָיָה לְעֵדוּת לָעַמִּים|And it shall be a testimony to the peoples
וְכָל-הַדְּבָרִים אֲשֶׁר צוּוִיתִי|And all the words which I commanded
וְלֹא תַעֲבֹר עַל-הַמִּצְוֹת|And do not transgress the commandments
וְאַתֶּם תִּשְׁמְרוּ אֶת-הַדְּבָרִים|And you shall keep the words
וְיִשְׁמְרוּ בְנֵי-יִשְׂרָאֵל|And the children of Israel shall keep
וְאָהַבְתָּ אֶת-יְהוָה בְּכָל-לְבָבְךָ|And you shall love the Lord with all your heart
וְלֹא תִשָּׁכַח מִפְּנֵי אֱלֹהִים|And do not forget the presence of God
וְתִקְרָא לְעוֹלָם|And you shall call upon Him forever
וְהָיָה בְרָכָה בָּרוּךְ|And there shall be a blessed blessing
וְיָרֵאתָ מִפְּנֵי יְהוָה|And you shall fear the Lord
וְאַתֶּם תִּהְיוּ קְדוֹשִׁים|And you shall be holy
וְהָיָה לְעוֹלָם|And it shall be forever
וְאָמַרְתָּ תּוֹרָתִי|And you shall speak My teaching
וְשָׁמַרְתָּ אֶת-דְּבָרַי|And you shall keep My words
וְאַל-תָּבוֹא לְעָלֶיךָ|And do not bring upon yourself
וְשָׁמַרְתָּ אֶת-כָּל-הַמִּצְוֹת|And you shall observe all the commandments
וְיִשְׁמְרוּ עֲדַתְכֶם|And your congregation shall keep
וְהָיָה לְעֵדוּת בֵּין הָעַמִּים|And it shall be a testimony among the nations
וְאָהַבְתָּ לְרֵעֲךָ כָּמוֹךָ|Love your neighbor as yourself
צַדִּיק בְּחַיָּיו יִשְׂמַח|The righteous shall rejoice in his life
יְהוָה רֹעִי לֹא אֶחְסָר|The Lord is my shepherd; I shall not want
תְּחִנּוֹת הָאֱמֶת יַצִּילֻנִי|The prayers of the faithful will save me
טוֹב-שֶׁבֶת בְּבֵית יְהוָה|It is good to dwell in the house of the Lord
חֶסֶד וֶאֱמֶת יִקְדְּמוּ פָּנֶיךָ|Kindness and truth shall go before you
בְּשָׁלוֹם יִרְבּוּ יְמֵי חַיֶּיךָ|In peace shall your days increase
יָשָׁר תִּהְיֶה בְּדֶרֶךְ|Be upright in your way
הַצַּדִּיק יַשְׁפִּיעַ בְּרָכָה|The righteous will bring forth blessing
לֹא-תִגְנֹב וְלֹא-תְכַחֵשׁ|Do not steal and do not lie
חָכְמָה תָּבִיא לָחַיִּים|Wisdom brings life
הַמְּשַׁלֵּם צַדִּיקוּת יִשְׂגֶּה|He who upholds righteousness shall succeed
בְּשָׁמַיִם יִהְיֶה גְּבוּרָה|In the heavens is strength
יָדֵךְ תַּשְׁלִים אֵת טוּבְךָ|Your hand shall fulfill your goodness
חֲסָדִים תִּקָּרֵב אֶת-יְהוָה|Kindness draws near to the Lord
נַפְשִׁי תִּשְׁכֹּן בַּשָּׁלוֹם|My soul shall dwell in peace
תּוֹרָה בְּלֵב תָּשִׁיב אוֹר|The Torah in the heart returns light
הַיָּם לֹא יִפְחַד לִפְנֵי הַצַּדִּיק|The sea shall not fear before the righteous
יְהוָה מְעוֹז לְעֹנִים|The Lord is a fortress for the oppressed
חֶסֶד אֵל יִגְבֹּר|The mercy of God prevails
יְהוָה מָלֵא חֶסֶד לְכָל-הַיִּשְׁרִים|The Lord is full of mercy to all the upright
צַדִּיק יִתְחַזֵּק בַּתּוֹרָה|The righteous are strengthened in the Torah
חֲכָמָה תִּנְחֶה דַּרְכֶּךָ|Wisdom will guide your path
בִּטְּחוּ בַיהוָה בְּכָל-לְבַבְכֶם|Trust in the Lord with all your heart
רְאוּת הַצַּדִּיק מְבָרֵךְ|The sight of the righteous brings blessing
חֶסֶד תָּמִיד יִתֵּן|Kindness is always given
אַל-תִּירָא מִפְּנֵי אָדָם|Do not fear man
יָדֵךְ תִּתֵּן לְדָל|Your hand shall give to the poor
נַפְשִׁי תָּשׁוּב אֶל-הַשָּׁלוֹם|My soul shall return to peace
רֹב חֶסֶד יִקְרָא לְכָל-הַיָּמִים|Great mercy shall be called upon all days
הַצַּדִּיק יִזְרַח כְּשֶׁמֶשׁ|The righteous shall shine like the sun
תְּפִלּוֹת צַדִּיקִים תַּצִּיל|The prayers of the righteous save
בְּרִית אֵל תְּחַזֵּק אֶת-הַלֵּב|The covenant of God strengthens the heart
חֶסֶד וֶאֱמֶת יִשְׁלֵב|Kindness and truth shall unite
אֱמוּנָה תָּשִׁיב נַפְשִׁי|Faith restores my soul
יְהוָה רוֹעֵי לֹא אֶחְסָר|The Lord is my shepherd; I shall lack nothing
חֶסֶד וְשָׁלוֹם יִתָּנוּ לְרֵעִים|Kindness and peace shall be given to neighbours
תּוֹרַת הַיָּשָׁר מְאִירָה|The Torah of the upright brings light
יָדֵךְ תְּעוֹז לַעֲשׂוֹת טוֹב|Your hand gives courage to do good
חַסְדֵּי יְהוָה לֹא-תָמוּשׁ|The mercies of the Lord never end
צַדִּיק יִרְאֶה אֶת-הַטּוֹב|The righteous shall see the good
שָׁלוֹם יִמְלֹךְ בְּלֵב הַיִּשְׁרִים|Peace shall reign in the hearts of the upright
תּוֹרָה וְמִצְוָה תְּשַׁמֵּר נַפְשִׁי|Torah and mitzvot guard my soul
חֲסָדִים לֹא-יָמוּשׁוּ|Kindness does not depart
יִרְאַת יְהוָה תְּחַיֵּנִי|The fear of the Lord gives me life
הַצַּדִּיק בְּבֵיתוֹ יִשְׂמַח|The righteous rejoice in their home
בְּתִקְוָה יַחֲזִיק הַיָּשָׁר|The upright hold fast in hope
חֶסֶד יָמִין לְכָל-בָּשָׂר|Kindness extends to all flesh
לֵב טוֹב יַשְׁלִים דֶּרֶךְ|A good heart completes the path
יְהוָה מוֹשִׁיעַ צַדִּיקִים|The Lord delivers the righteous
עֵינַי אֶל-יְהוָה תִּשְׁתַּקֵּעַ|My eyes are fixed on the Lord
תּוֹרַת יְהוָה אוֹר לְנַפְשִׁי|The Torah of the Lord is light to my soul
חָכְמָה וְיָשָׁר יַעַנְכוּ|Wisdom and uprightness answer
בְּרִית אֱמוּנָה תִּתְחַזֵּק|The covenant of faith is strengthened
צַדִּיק יִפְרַח כְּעֵץ|The righteous shall flourish like a tree
חֶסֶד יָמִים וְלַיְלָה|Kindness all day and night
יִרְאַת יְהוָה תָּשִׂים שָׁלוֹם|The fear of the Lord brings peace
הַלֵּב הַטּוֹב יַעֲשֶׂה צְדָקָה|A good heart does righteousness
יְהוָה עֹז צַדִּיקִים|The Lord is the strength of the righteous
חֶסֶד יִשְׁפּוֹעַ כְּמוֹ מַיִם|Kindness shall flow like water
צַדִּיק בְּמִצְוֹת יִשְׂמַח|The righteous rejoice in the commandments
תּוֹרָה בְּלֵב נַפְשִׁי יָרוּם|Torah in my heart shall be exalted
שָׁלוֹם יִשְׁכֹּן בְּתוֹכֵךְ|Peace shall dwell within you
חֲסָדִים יִשְׁלְבוּ לְעוֹלָם|Kindness shall unite forever
הַצַּדִּיק יִתְחַזֵּק בְּתְפִלָּה|The righteous are strengthened in prayer
יָדֵךְ תִּסְעָד לְחָסֵד|Your hand shall help with kindness
חֶסֶד אֵל יִשְׁמֹר עָלֵינוּ|The mercy of God shall watch over us
צַדִּיק בְּתֹורָתוֹ יִשְׂמַח|The righteous rejoice in their Torah
יְהוָה אוֹר לְכָל-הַיִּשְׁרִים|The Lord is light for all the upright
חָכְמָה תַּנְחֵנִי בְּדֶרֶךְ|Wisdom will lead me in the way
צַדִּיק תִּשְׁמֹר נַפְשׁוֹ|The righteous guard their soul
חֶסֶד יָמִים וְלַיְלָה יִשְׁרֹף|Kindness burns day and night
יִרְאַת יְהוָה תְּחַיֵּנִי|The fear of the Lord gives life
תּוֹרַת הַיָּשָׁר אוֹר לְדֶרֶךְ|The Torah of the upright is light to the path
יְהוָה מַצִּיל עִם-חָסֶד|The Lord saves with mercy
צַדִּיק יַרְאֶה אֶת-הַטּוֹב|The righteous shall see the good
חֶסֶד וָאֱמֶת יִשְׁלְבוּ|Kindness and truth shall unite
הַלֵּב הַטּוֹב יַעֲשֶׂה חָסֶד|A good heart shall do kindness
תּוֹרָה בְּלֵב תָּשִׁיב אוֹר|Torah in the heart returns light
צַדִּיק יִשְׂמַח בַּיהוָה|The righteous rejoice in the Lord
חֶסֶד יִשְׁמֹר אֶת-הַיָּמִים|Kindness guards the days
יְהוָה עֹז לַצַּדִּיקִים|The Lord is strength to the righteous
צַדִּיק בְּחֵן יִשְׁמַח|The righteous shall rejoice in favor
חָכְמָה תַּנְחֵנִי בְּחֶסֶד|Wisdom shall guide me in kindness
יִרְאַת יְהוָה תְּמַלֵּא לֵב|The fear of the Lord fills the heart
תּוֹרָה וְחֶסֶד מְאִירִים נַפְשִׁי|Torah and kindness enlighten my soul
צַדִּיק יִרְאֶה אוֹר|The righteous shall see light
חֶסֶד וְאֱמוּנָה תִּשְׁלַבְנָה|Kindness and faith shall unite
יָדֵךְ תִּסְעָד לְצְדָקָה|Your hand shall help with righteousness
צַדִּיק יִשְׁמַח בְּחֶסֶד|The righteous rejoice in kindness
חֲסָדִים תִּקָּרֵב אֶת-הַצַּדִּיק|Kindness draws near to the righteous
תּוֹרָה אוֹר לְלֵב|Torah is light to the heart
יְהוָה מוֹשִׁיעַ בְּחֶסֶד|The Lord delivers with mercy
צַדִּיק בְּמִצְוֹתוֹ יִשְׂמַח|The righteous rejoice in their commandments
חֶסֶד יִשְׁפֹּט לְעוֹלָם|Kindness shall judge forever
יָדֵךְ תִּתֵּן לְטוֹב|Your hand shall give for good
צַדִּיק יַעֲלֶה כְּשֶׁמֶשׁ|The righteous shall rise like the sun
חָכְמָה תְּחַיֵּנִי|Wisdom gives me life
יְהוָה מָלֵא חֶסֶד וָאֱמוּנָה|The Lord is full of mercy and truth
יְהוָה צַדִּיק בְּכָל-דְּרָכָיו|The Lord is righteous in all His ways
צַדִּיק יִחֲזִיק בְּחָכְמָה|The righteous hold fast to wisdom
חֶסֶד לְעוֹלָם יִשְׁמֹר|Kindness shall guard forever
יִרְאַת יְהוָה תִּנְחֵנִי|The fear of the Lord guides me
תּוֹרָה אוֹר לְנַפְשִׁי|The Torah is light to my soul
צַדִּיק יִשְׁמַח בְּחֶסֶד וּבָאֱמוּנָה|The righteous rejoice in kindness and faith
חָכְמָה וְתִשְׁמֹר נַפְשִׁי|Wisdom shall guard my soul
יָדֵךְ תִּתֵּן לַעֲשׂוֹת טוֹב|Your hand shall give to do good
צַדִּיק יִרְאֶה בְּאוֹר הַתּוֹרָה|The righteous shall see in the light of the Torah
חֶסֶד אֵל יִשְׁמֹר עַל-נַפְשִׁי|The mercy of God watches over my soul
תְּפִלּוֹת צַדִּיקִים תַּצִּיל מִצָּר|The prayers of the righteous save from distress
צַדִּיק יִשְׂמַח בַּיהוָה לְעוֹלָם|The righteous rejoice in the Lord forever
חֶסֶד תָּמִיד יִשְׁפּוֹט לְצַדִּיקִים|Kindness always rules for the righteous
יְהוָה מוֹשִׁיעַ לַיָּשָׁרִים|The Lord saves the upright
צַדִּיק יִפְרַח כְּעֵץ בַּשָּׂדֶה|The righteous shall flourish like a tree in the field
חֶסֶד יָמִים יִתֵּן לְכָל-אָדָם|Kindness shall be given to all people
יְהוָה אוֹר לְדֶרֶךְ הַצַּדִּיקִים|The Lord is light to the path of the righteous
צַדִּיק בְּתְפִלָּתוֹ יִשְׁמַע|The righteous shall be heard in prayer
חָכְמָה תִּנְחֵנִי בְּדֶרֶךְ צַדִּיקִים|Wisdom guides me in the way of the righteous
יָדֵךְ תִּתֵּן לְצַדִּיקִים|Your hand shall give to the righteous
צַדִּיק יִתְחַזֵּק בְּתּוֹרָה וּבְחֶסֶד|The righteous are strengthened in Torah and kindness
חֶסֶד וְאֱמוּנָה יִשְׁלְבוּ בְּלֵב|Kindness and faith unite in the heart
תּוֹרָה בְּלֵב הַיָּשָׁר מְאִירָה|Torah in the heart of the upright brings light
צַדִּיק יִשְׂמַח בְּחֶסֶד עַל-לְבָבוֹ|The righteous rejoice in kindness in their heart
יְהוָה עֹז לַצַּדִּיקִים בַּיּוֹם הָרָע|The Lord is strength to the righteous on the evil day
חָכְמָה תְּמַלֵּא לֵב וְתִשְׁמֹר נַפְשִׁי|Wisdom fills the heart and guards the soul
צַדִּיק יִרְאֶה חֶסֶד אֵל|The righteous shall see the mercy of God
חֶסֶד יָמִים וְלַיְלָה יִשְׁפֹּט|Kindness rules day and night
יְהוָה מַצִּיל אֶת-הַצַּדִּיקִים|The Lord delivers the righteous
צַדִּיק יִשְׂמַח בַּתּוֹרָה וּבְחֶסֶד|The righteous rejoice in Torah and kindness
חָכְמָה וְיָשָׁר יַעַנְכוּ נַפְשִׁי|Wisdom and uprightness answer my soul
יָדֵךְ תִּתֵּן לַצַּדִּיקִים בְּעֶזְרָה|Your hand shall give help to the righteous
צַדִּיק יִתְעַלֶּה בְּחֶסֶד וּבְתוֹרָה|The righteous shall ascend in kindness and Torah
חֶסֶד יִשְׁפֹּט לְעוֹלָם וְעֶד|Kindness shall rule forever and ever
יְהוָה אוֹר לְנַפְשִׁי וּלְלִבִּי|The Lord is light to my soul and heart
צַדִּיק בְּתּוֹרָתוֹ מְאִירָה|The righteous shines in their Torah
חָכְמָה תַּנְחֵנִי בְּדֶרֶךְ צַדִּיקִים|Wisdom guides me in the path of the righteous
יָדֵךְ תִּתֵּן לְטוֹב וְלַצַּדִּיקִים|Your hand shall give for good and to the righteous
צַדִּיק יִשְׁמַח בְּחֶסֶד תָּמִיד|The righteous rejoice in constant kindness
חֶסֶד וְאֱמוּנָה יִשְׁלְבוּ לְעוֹלָם|Kindness and faith unite forever
תּוֹרָה בְּלֵב הַצַּדִּיק מְאִירָה|Torah in the heart of the righteous brings light
יְהוָה מוֹשִׁיעַ בְּחֶסֶד וְאֱמוּנָה|The Lord delivers in mercy and faith
צַדִּיק בְּתּפִלּוֹ יִשְׁמַע|The righteous are heard in prayer
חָכְמָה תִּתֵּן חַיִים לְנַפְשִׁי|Wisdom gives life to my soul
יָדֵךְ תִּסְעָד לְצְדָקָה וּלְחֶסֶד|Your hand shall help in righteousness and kindness
צַדִּיק יִשְׂמַח בַּיהוָה בְּחֶסֶד|The righteous rejoice in the Lord in kindness
חֶסֶד יִשְׁפֹּט לְעֹלָם|Kindness rules forever
תּוֹרָה אוֹר לְלֵב הַצַּדִּיקִים|Torah is light to the hearts of the righteous
יְהוָה עֹז לַצַּדִּיקִים בְּכָל-יָמִים|The Lord is strength to the righteous at all times
צַדִּיק יִתְחַזֵּק בְּחֶסֶד וְתִשְׁמֹר נַפְשׁוֹ|The righteous are strengthened in kindness and guard their soul
חָכְמָה תִּנְחֵנִי לְעוֹלָם|Wisdom guides me forever
יָדֵךְ תִּתֵּן לַצַּדִּיקִים בְּחֶסֶד|Your hand shall give to the righteous in kindness
צַדִּיק בְּתוֹרָתוֹ יִשְׁמַח|The righteous rejoice in their Torah
חֶסֶד וְאֱמוּנָה תִּשְׁלַבְנָה|Kindness and faith shall unite
יְהוָה אוֹר לְכָל-הַיָּשָׁרִים|The Lord is light to all the upright
צַדִּיק יִרְאֶה חֶסֶד אֵל|The righteous shall see the mercy of God
חָכְמָה תַּעֲלֶה לְעֵינַי|Wisdom rises before my eyes
יָדֵךְ תִּתֵּן לַצַּדִּיקִים בְּחֶסֶד וּבְאֱמוּנָה|Your hand shall give to the righteous in kindness and faith
צַדִּיק יִשְׂמַח בַּיהוָה תָּמִיד|The righteous rejoice in the Lord always
חֶסֶד יִשְׁמֹר עַל-הַלֵּב|Kindness guards the heart
תּוֹרָה בְּלֵב הַיָּשָׁר מְאִירָה|Torah in the heart of the upright brings light
יְהוָה מוֹשִׁיעַ לַצַּדִּיקִים בְּחֶסֶד|The Lord delivers the righteous in mercy
צַדִּיק בְּתּוֹרָתוֹ יִשְׂמַח|The righteous rejoice in their Torah
חָכְמָה תַּנְחֵנִי בְּדֶרֶךְ הַצַּדִּיקִים|Wisdom guides me in the path of the righteous
יָדֵךְ תִּתֵּן לַצַּדִּיקִים בְּעוֹז|Your hand shall give to the righteous with strength
צַדִּיק יִשְׂמַח בַּחֶסֶד וְתִשְׁמֹר נַפְשׁוֹ|The righteous rejoice in kindness and guard their soul
חֶסֶד יִשְׁפֹּט לְעוֹלָם|Kindness rules forever
יְהוָה רוֹפֵא לַנֶּפֶשׁ|The Lord heals the soul
צַדִּיק יִתְחַזֵּק בְּתּוֹרָה|The righteous are strengthened in Torah
חֶסֶד יִשְׁפֹּט בֵּין הָאָדָם לְרֵעֵהוּ|Kindness rules between a person and his neighbour
יָדֵךְ תִּסְעָד לַחָכְמָה|Your hand shall support wisdom
צַדִּיק בְּלִבּוֹ יַאֲמִין|The righteous believe in his heart
חָכְמָה תַּנְחֵנִי בְּדֶרֶךְ טוֹבָה|Wisdom guides me in the good path
יְהוָה מֵאִיר אֶת-דַּרְכֵּי הַצַּדִּיקִים|The Lord lights the paths of the righteous
צַדִּיק יִשְׂמַח בְּעֵזֶר יְהוָה|The righteous rejoice in the help of the Lord
חֶסֶד יִשְׁמֹר לְעוֹלָם עַל-נַפְשִׁי|Kindness shall guard my soul forever
יָדֵךְ תִּתֵּן לַצַּדִּיקִים בְּתִקְוָה|Your hand shall give to the righteous with hope
צַדִּיק יִתְרַחֵשׁ בְּתְּפִלּוֹת|The righteous are honoured in their prayers
חָכְמָה תַּעֲשֶׂה נַפְשִׁי לְטוֹב|Wisdom makes my soul good
יְהוָה עֹז לַצַּדִּיקִים בְּצָרָה|The Lord is strength to the righteous in distress
צַדִּיק יִשְׁמַח בְּחֶסֶד אֵל|The righteous rejoice in God’s mercy
חֶסֶד תַּשְׁלִיט לְעוֹלָם|Kindness shall prevail forever
יָדֵךְ תִּסְעָד לְטוֹבָה|Your hand shall support goodness
צַדִּיק בְּתוֹרָתוֹ יִשְׂמַח לְעוֹלָם|The righteous rejoice in Torah forever
חָכְמָה תִּשְׁמֹר נַפְשִׁי מִרָע|Wisdom guards my soul from evil
יְהוָה מוֹשִׁיעַ לַיָּשָׁרִים|The Lord delivers the upright
צַדִּיק יִרְאֶה אֶת-טוֹב יְהוָה|The righteous shall see the goodness of the Lord
חֶסֶד וְאֱמוּנָה יִשְׁלְבוּ בְּלֵב|Kindness and faith unite in the heart
יָדֵךְ תִּתֵּן לַצַּדִּיקִים בְּחֵן|Your hand shall give to the righteous with grace
צַדִּיק יִשְׁמַח בַּתּוֹרָה וּבְחֶסֶד|The righteous rejoice in Torah and kindness
חָכְמָה תִּנְחֵנִי בְּדֶרֶךְ הַיָּשָׁר|Wisdom guides me in the path of the upright
יְהוָה אוֹר לַצַּדִּיקִים|The Lord is light to the righteous
צַדִּיק בְּתּפִלּוֹ יִשְׁמַע|The righteous are heard in prayer
חֶסֶד תַּעֲלֶה בְּלֵב הַיָּשָׁרִים|Kindness rises in the hearts of the upright
יָדֵךְ תִּתֵּן לַצַּדִּיקִים בְּעוֹז|Your hand shall give to the righteous with strength
צַדִּיק יִשְׂמַח בַּחֶסֶד וּבְאֱמוּנָה|The righteous rejoice in kindness and faith
חָכְמָה תַּנְחֵנִי בְּדֶרֶךְ צַדִּיקִים|Wisdom guides me in the path of the righteous
יְהוָה מוֹשִׁיעַ לַצַּדִּיקִים בְּחֶסֶד|The Lord delivers the righteous in mercy
צַדִּיק בְּתוֹרָתוֹ מְאִירָה|The righteous shines in Torah
חֶסֶד וְאֱמוּנָה תִּשְׁלַבְנָה בְּלֵב|Kindness and faith unite in the heart
יָדֵךְ תִּתֵּן לַצַּדִּיקִים בְּחֶסֶד|Your hand shall give to the righteous in kindness
צַדִּיק יִשְׂמַח בַּיהוָה בְּחֶסֶד|The righteous rejoice in the Lord in kindness
חָכְמָה תְּשַׁלֵּחַ אֶת-נַפְשִׁי|Wisdom shall send forth my soul
יְהוָה אוֹר לְדֶרֶךְ הַצַּדִּיקִים|The Lord is light to the path of the righteous
צַדִּיק בְּחֶסֶד יִשְׂמַח|The righteous rejoice in kindness
חֶסֶד יִשְׁמֹר עַל-הַלֵּב וְעַל-הַנֶּפֶשׁ|Kindness guards the heart and soul
יָדֵךְ תִּתֵּן לַצַּדִּיקִים בְּתִקְוָה|Your hand shall give to the righteous with hope
צַדִּיק יִשְׁמַח בַּתּוֹרָה תָּמִיד|The righteous rejoice in Torah always
חָכְמָה תִּנְחֵנִי בְּדֶרֶךְ טוֹבָה|Wisdom guides me in the good path
יְהוָה מוֹשִׁיעַ לַצַּדִּיקִים בְּעֵזֶר|The Lord delivers the righteous with help
צַדִּיק בְּתּוֹרָתוֹ יִשְׂמַח לְעוֹלָם|The righteous rejoice in Torah forever
חֶסֶד וְאֱמוּנָה יִשְׁלְבוּ בְּנֶפֶשׁ|Kindness and faith unite in the soul
יָדֵךְ תִּתֵּן לַצַּדִּיקִים בְּחֵן וּבְטוֹבָה|Your hand shall give to the righteous with grace and goodness
צַדִּיק יִשְׂמַח בַּיהוָה תָּמִיד|The righteous rejoice in the Lord always
חָכְמָה תַּנְחֵנִי לְטוֹבָה|Wisdom guides me to goodness
יְהוָה אוֹר לְנַפְשִׁי|The Lord is light to my soul
צַדִּיק בְּתוֹרָתוֹ מֵאִירָה|The righteous shines in Torah
חֶסֶד תִּשְׁלַב בְּלֵב הַיָּשָׁרִים|Kindness unites in the hearts of the upright
יָדֵךְ תִּתֵּן לַצַּדִּיקִים בְּעוֹז וּבְחֶסֶד|Your hand shall give to the righteous with strength and kindness
צַדִּיק יִשְׂמַח בַּחֶסֶד וְתִשְׁמֹר נַפְשׁוֹ|The righteous rejoice in kindness and guard their soul
חָכְמָה תַּנְחֵנִי בְּדֶרֶךְ הַצַּדִּיקִים|Wisdom guides me in the path of the righteous
יְהוָה מוֹשִׁיעַ לַצַּדִּיקִים בְּחֶסֶד וְאֱמוּנָה|The Lord delivers the righteous in mercy and faith
צַדִּיק בְּתוֹרָתוֹ יִשְׂמַח|The righteous rejoice in their Torah
חֶסֶד וְאֱמוּנָה תִּשְׁלַבְנָה|Kindness and faith shall unite
יָדֵךְ תִּתֵּן לַצַּדִּיקִים בְּחֶסֶד|Your hand shall give to the righteous in kindness
צַדִּיק יִשְׂמַח בַּיהוָה בְּחֶסֶד|The righteous rejoice in the Lord in kindness
חָכְמָה תַּעֲלֶה בְּנַפְשִׁי|Wisdom rises in my soul
יְהוָה אוֹר לְדֶרֶךְ הַצַּדִּיקִים|The Lord is light to the path of the righteous
צַדִּיק בְּחֶסֶד יִשְׂמַח|The righteous rejoice in kindness
יְהוָה מְקוֹר חַיִּים לְצַדִּיקִים|The Lord is the source of life for the righteous
צַדִּיק יִשְׂמַח בְּדֶרֶךְ הָאֱמֶת|The righteous rejoice in the way of truth
חֶסֶד יִרְדָּף אֶת הַצַּדִּיקִים|Kindness pursues the righteous
יָדֵךְ תִּסְעָד בְּעֵזֶר הַצַּדִּיקִים|Your hand shall support the righteous with help
חָכְמָה תַּעֲלֶה עַל הָרָע|Wisdom rises above evil
יְהוָה עֹז וּמָעוֹז לַמִּתְיַשְּׁרִים|The Lord is strength and refuge for the upright
צַדִּיק בְּתוֹרָתוֹ יִתְחַזֵּק|The righteous are strengthened in their Torah
חֶסֶד מֵאִיר לִבֵּי הָאָדָם|Kindness illuminates the heart of man
יָדֵךְ תִּתֵּן בְּחֵן לַצַּדִּיקִים|Your hand shall give graciously to the righteous
צַדִּיק יִשְׂמַח בַּיְהוָה תָּמִיד|The righteous rejoice in the Lord always
חָכְמָה תִּנְחֵנִי בְּדֶרֶךְ טוֹבָה וְיָשָׁרָה|Wisdom guides me in the good and upright path
יְהוָה מוֹשִׁיעַ בְּצָרָה לַצַּדִּיקִים|The Lord delivers the righteous in distress
צַדִּיק בְּחֶסֶד וּבְאֱמוּנָה יִתְחַזֵּק|The righteous are strengthened in kindness and faith
חֶסֶד תִּשְׁמֹר נַפְשִׁי|Kindness shall guard my soul
יָדֵךְ תִּתֵּן עַל הָרַע וְלֹא תִפְגַּע|Your hand shall give over evil and not harm
צַדִּיק בְּתְפִלּוֹתָיו יִשָּׁמֵעַ|The righteous are heard in their prayers
חָכְמָה מֵאִירָה לְלֵב הָאָדָם|Wisdom illuminates the heart of man
יְהוָה מוֹשִׁיעַ אֶת הַצַּדִּיקִים בְּחֶסֶד|The Lord delivers the righteous in mercy
צַדִּיק יִשְׂמַח בַּתּוֹרָה וּבְחֶסֶד|The righteous rejoice in Torah and kindness
חֶסֶד וְאֱמוּנָה תִּשְׁלַבְנָה בְּנַפְשִׁי|Kindness and faith shall unite in my soul
יָדֵךְ תִּתֵּן בְּחֶסֶד לַצַּדִּיקִים|Your hand shall give in kindness to the righteous
צַדִּיק בְּתּוֹרָתוֹ יִשְׂמַח|The righteous rejoice in their Torah
חָכְמָה תִּנְחֵנִי בְּדֶרֶךְ הַצַּדִּיקִים|Wisdom guides me in the path of the righteous
יְהוָה אוֹר לִנְפָשִׁי|The Lord is light to my soul
צַדִּיק בְּחֶסֶד יִשְׂמַח תָּמִיד|The righteous rejoice in kindness always
חֶסֶד יִשְׁלֵב בְּלֵב הַיָּשָׁרִים|Kindness unites in the hearts of the upright
יָדֵךְ תִּתֵּן לַצַּדִּיקִים בְּחֵן וּבְחֶסֶד|Your hand shall give to the righteous with grace and kindness
צַדִּיק יִשְׂמַח בַּיהוָה בְּחֶסֶד|The righteous rejoice in the Lord in kindness
חָכְמָה תַּנְחֵנִי לְטוֹבָה|Wisdom guides me to goodness
יְהוָה מוֹשִׁיעַ לַצַּדִּיקִים בְּחֶסֶד וּבְאֱמוּנָה|The Lord delivers the righteous in mercy and faith
צַדִּיק בְּתוֹרָתוֹ מֵאִירָה|The righteous shines in Torah
חֶסֶד תִּשְׁלַב בְּלֵב הַיָּשָׁרִים|Kindness unites in the hearts of the upright
יָדֵךְ תִּתֵּן לַצַּדִּיקִים בְּעוֹז וּבְחֶסֶד|Your hand shall give to the righteous with strength and kindness
צַדִּיק יִשְׂמַח בַּחֶסֶד וְיִשְׁמֹר נַפְשׁוֹ|The righteous rejoice in kindness and guard their soul
חָכְמָה תַּנְחֵנִי בְּדֶרֶךְ הַצַּדִּיקִים|Wisdom guides me in the path of the righteous
יְהוָה מוֹשִׁיעַ בְּחֶסֶד לַצַּדִּיקִים|The Lord delivers the righteous in mercy
צַדִּיק בְּתוֹרָתוֹ יִשְׂמַח|The righteous rejoice in their Torah
חֶסֶד וְאֱמוּנָה יִשְׁלְבוּ בְּנֶפֶשׁ|Kindness and faith shall unite in the soul
יָדֵךְ תִּתֵּן לַצַּדִּיקִים בְּחֵן|Your hand shall give to the righteous with grace
צַדִּיק יִשְׂמַח בַּיהוָה תָּמִיד|The righteous rejoice in the Lord always
חָכְמָה תַּעֲלֶה בְּנַפְשִׁי|Wisdom rises in my soul
יְהוָה אוֹר לְדֶרֶךְ הַצַּדִּיקִים|The Lord is light to the path of the righteous
צַדִּיק בְּחֶסֶד יִשְׂמַח|The righteous rejoice in kindness
יְהוָה מְחַזֵּק אֶת הַיָּשָׁרִים בְּצַדִּיקוּת|The Lord strengthens the upright in righteousness
צַדִּיק יִשְׂמַח בַּעֲשׂוֹת טוֹב|The righteous rejoice in doing good
חֶסֶד וֶאֱמוּנָה מְנַהֲלִים אֶת חַיֵּינוּ|Kindness and faith guide our lives
יָדֵךְ תִּשְׁמֹר עַל הַצַּדִּיקִים|Your hand shall guard the righteous
חָכְמָה תִּתֵּן לָנוּ נְבוּנוּת|Wisdom grants us understanding
יְהוָה מוֹשִׁיעַ בַּצַּרָה וּמִן הַסּוֹכֵן|The Lord delivers from trouble and danger
חֶסֶד נוֹתֵן חַיִּים לְנֶפֶשׁ|Kindness gives life to the soul
יָדֵךְ תִּתֵּן לַצַּדִּיקִים בְּחֶסֶד וּבֶאֱמֶת|Your hand shall give to the righteous in kindness and truth
צַדִּיק יִשְׂמַח בְּתְפִלּוֹתָיו|The righteous rejoice in their prayers
חָכְמָה מוֹשִׁיעָה מִן הָרָע|Wisdom delivers from evil
יְהוָה אוֹר לְנַפְשִׁי וּלְלִבִּי|The Lord is light to my soul and heart
צַדִּיק בְּחֶסֶד וְיִשְׁמֹר דֶּרֶךְ נָכוֹן|The righteous rejoice in kindness and walk the correct path
מִי שֶׁמְּדַבֵּר אֱמֶת בְּכָל עֵת יִתְקוֹן בְּלִבּוֹ|Who speaks truth at all times finds stability in their heart
תּוֹרָה בְּלֵב בּוֹרֵאת חָכְמָה|Torah in the heart creates wisdom
עֲשֵׂה צְדָקָה וּפְרֹשׂ חֶסֶד לְעֵמֶךָ|Do justice and extend kindness to your people
יָרֵא אֱלֹהִים יִשְׁכֹּן בְּבֵיתוֹ|One who fears God dwells in peace at home
לֹא בַחָכְמָה לְבַדָּה תִשְׁמַח הַנֶּפֶשׁ|The soul does not rejoice by wisdom alone
חֶסֶד וֶאֱמֶת מַבְדִּילִים בֵּין אָדָם לְרֵעֵהוּ|Kindness and truth distinguish man from his neighbour
יְדֵי עוֹשֵׂה טוֹב לֹא תִמּוֹשׁ|The hands that do good never grow weary
נְשָׁמָה שֶׁבְּתוֹרָה מְאִירָה כְּאוֹר|A soul in Torah shines like light
הַכָּתוּב מֵעוֹלָם לֹא יִכָּבֵשׁ|What is written in eternity cannot be erased
שׁוּבָה בְּדֶרֶךְ הַצְּדָקָה וְתִמָּצֵא שָׁלוֹם|Return to the path of righteousness and you will find peace
מִלָּה טוֹבָה בְּפֶה מַרְפֵּא רוּחַ|A good word spoken heals the spirit
חָכְמָה בְּעֲבוּר הַצִּדְקָה מוֹרֶה חַיִּים|Wisdom for the sake of righteousness teaches life
לֵב טָהוֹר מַבִּיט בְּעֵינֵי הָאֱלֹהִים|A pure heart gazes into the eyes of God
חָכְמָה תְּעַמֵּד דֶּרֶךְ הַיָּשָׁר|Wisdom shall establish the path of the upright
יָדֵךְ תִּתֵּן לְלַמֵּד חָכְמָה|Your hand shall give to teach wisdom